............................................................
.........................^^^^^^^^^^.........................
.....................^^^^....^^....^^^^.....................
..................^^^........^^........^^^..................
................^^...........^^...........^^................
...............^.............^^.............^...............
..............^..............^^..............^..............
.............^.......*.......^^.......P.......^.............
.............^...............^^...............^.............
............^...............^^^^...............^............
............^.............^^:^^:^^.............^............
.............^..........^^:::^^:::^^..........^.............
.............^........^^:::::^^:::::^^........^.............
..............^.....^^:::::::^^:::::::^^.....^..............
...............^..^^:::::::::^^:::::::::^^..^...............
................^^:::::::::::^^:::::::::::^^................
..................^^^::::::::^^::::::::^^^..................
.....................^^^^::::^^::::^^^^.....................
.........................^^^^^^^^^^.........................
............................................................