############################################################
############################################################
##########################...###############################
#######.....##############...###############################
#######.....##############...###############################
#######.....##############...###############################
#########.#################.#######....#####################
#########.#################..........*.#####################
P.........#################.#######....#####################
#########.#################.################################
#########..........::::......###############################
#########.########.####.S....###############################
######....########.####......###############################
##################...........###############################
############################################################
############################################################
############################################################
############################################################
############################################################
############################################################
