.#.#.:.#.#.:.#.#.:.#.#.:.#.#.:.#.#.:.#.#.:.#.#.:.#.#.:.#.#.:
##...###...###...###...###...###...###...###...###...###...#
.:.#.#.:S#.#.:.#.#.:.#.#.:.#.#.:.#.#.:.#.#S:.#.#.:.#.#.:.#.#
.###...###...###...###...###...###...###...###...###...###..
.#.:S#.#.:.#.#.:.#.#.:.#.#.:.#.#.:.#.#.:.#.#.:.#.#.:.#.#.:.#
...###...###P..###...###...###...###...###...###...###...###
S#.#.:.#.#.:.#.#.:.#.#.:.#.#S:.#.#.:.#.#.:.#.#S:.#.#.:.#.#.:
##...###...###...###...###...###...###...###...###...###...#
.:.#.#.:.#.#.:.#.#.:.#.#.:.#.#.:.#.#.:.#.#.:.#.#.:.#.#.:.#.#
.###...###...###...###...###...###...###...###...###...###..
.#.:.#.#.:.#.#.:.#.#.:.#.#.:.#.#S:.#.#.:.#.#.:.#.#.:.#.#S:.#
...###...###...###...###...###...###...###...###...###...###
.#.#.:.#.#.:.#.#.:.#.#.:.#.#.:.#.#.:.#.#S:.#.#.:.#.#.:.#.#.:
##.S.###...###...###...###...###...###...###...###...###...#
.:.#.#.:.#.#S:.#.#.:.#.#.:.#.#S:.#.#.:.#.#.:.#.#S:.#.#S:.#.#
.###...###...###...###...###...###...###...###...###...###..
.#.:.#.#.:.#.#.:.#.#.:.#.#.:.#.#.:.#.#.:.#.#.:.#.#.:.#.#.:.#
*..###...###...###...###...###...###...###...###...###...###
.#.#.:.#.#.:.#.#S:.#.#.:.#.#.:.#.#.:.#.#S:.#.#.:.#.#.:.#.#.:
##...###...###...###...###...###...###...###...###...###...#